111111111111011111111111111111111111111111111111111111
100000000001010000000000000000000000000000000000000001
100000002201010000000002200000000000022200000000000001
100000000001010000000000000000000000000000000000000001
100222000000000000000000000000000000000000000000000001
100000000000000000000000000000000000000000000000000001
100000000000000000000000022000000000000000000000000001
100000000000000000000000000000000000000000000000000001
100220000000000000000000000000000000000000022000000001
100000000022000000000000000000000000000000000000000001
100020000000000000000000220000000000000000000000000001
100000000000000000000000000000000000000000000000000001
100000000000000000000000000000000220000000000000000001
100000000000000000000000000000000000000000000000000001
100000000000000220000000000000000000000000220000000001
100000000000000000000000000000000000000000000000000001
100000020000000000000000000000000000000000000000000001
100000000000000000000000002000000000000020000000000001
100000000000000000000000000000000000000000000000000001
111111111111111111111111111111111111111111111111111111